417	1
Acanthognathus.ocellatus	R
Acanthognathus.rudis	R
Acanthomyrmex.ferox	R
Acanthomyrmex.notabilis	R
Acromyrmex.balzani	R
Acromyrmex.coronatus	R
Acromyrmex.crassispinus	R
Acromyrmex.fracticornis	R
Acromyrmex.landolti	R
Acromyrmex.octospinosus	R
Acromyrmex.subterraneus	R
Acropyga.epedana	R
Aenictus.laeviceps	R
Amblyopone.australis	R
Aneuretus.simoni	R
Anochetus.bequaerti	S
Anochetus.diegensis	R
Anochetus.faurei	S
Anochetus.katonae	S
Anochetus.kempfi	R
Anochetus.levaillanti	R
Anoplolepis.custodiens	R
Anoplolepis.gracilipes	R
Aphaenogaster.araneoides	R
Aphaenogaster.gibbosa	R
Aphaenogaster.longiceps	R
Aphaenogaster.rudis	R
Aphaenogaster.senilis	R
Aphaenogaster.subterranea	R
Apomyrma.stygia	R
Apterostigma.collare	R
Apterostigma.dentigerum	R
Atopomyrmex.mocquerysi	R
Atta.cephalotes	R
Atta.colombica	R
Atta.laevigata	R
Atta.mexicana	R
Atta.sexdens	R
Atta.texana	R
Atta.vollenweideri	R
Azteca.forelii	R
Basiceros.manni	R
Blepharidatta.conops	R
Brachymyrmex.depilis	R
Brachymyrmex.patagonicus	R
Brachyponera.chinensis	S
Camponotus.aethiops	R
Camponotus.americanus	R
Camponotus.castaneus	R
Camponotus.chromaiodes	R
Camponotus.compressus	R
Camponotus.consobrinus	R
Camponotus.crassus	R
Camponotus.cruentatus	R
Camponotus.dalmaticus	R
Camponotus.fallax	R
Camponotus.fellah	R
Camponotus.floridanus	R
Camponotus.foreli	R
Camponotus.herculeanus	R
Camponotus.japonicus	R
Camponotus.lateralis	R
Camponotus.ligniperda	R
Camponotus.modoc	R
Camponotus.mus	R
Camponotus.nearcticus	R
Camponotus.pennsylvanicus	R
Camponotus.piceus	R
Camponotus.pilicornis	R
Camponotus.planatus	R
Camponotus.punctulatus	R
Camponotus.rectangularis	R
Camponotus.sanctus	R
Camponotus.saxatilis	R
Camponotus.senex	R
Camponotus.sericeus	R
Camponotus.socius	R
Camponotus.vagus	R
Camponotus.vividus	R
Camponotus.yamaokai	R
Cardiocondyla.emeryi	S
Cardiocondyla.koshewnikovi	S
Cardiocondyla.mauritanica	S
Cardiocondyla.nuda	S
Cardiocondyla.obscurior	S
Carebara.diversa	S
Carebara.overbecki	S
Carebara.perpusilla	S
Cataglyphis.aenescens	R
Cataglyphis.bicolor	R
Cataglyphis.bombycina	R
Cataglyphis.cursor	R
Cataglyphis.iberica	R
Cataglyphis.nigra	R
Cataglyphis.rosenhaueri	R
Cataglyphis.velox	R
Cataulacus.muticus	R
Centromyrmex.sellaris	R
Cephalotes.atratus	R
Cephalotes.goniodontus	R
Cephalotes.pusillus	R
Cephalotes.texanus	R
Cephalotes.varians	R
Cerapachys.sulcinodis	R
Crematogaster.ashmeadi	R
Crematogaster.auberti	R
Crematogaster.cerasi	R
Crematogaster.minutissima	R
Crematogaster.rogenhoferi	R
Crematogaster.scutellaris	R
Crematogaster.sordidula	R
Cryptopone.gilva	R
Cryptopone.motschulskyi	R
Cryptopone.sauteri	R
Cyphomyrmex.rimosus	R
Daceton.armigerum	R
Diacamma.rugosum	G
Dinoponera.gigantea	G
Dinoponera.grandis	G
Dinoponera.quadriceps	G
Discothyrea.kamiteta	R
Discothyrea.sauteri	R
Dolichoderus.attelaboides	R
Dolichoderus.mariae	R
Dolichoderus.quadripunctatus	R
Dolichoderus.thoracicus	R
Dorylus.laevigatus	R
Dorylus.wilverthi	R
Dorymyrmex.bureni	R
Eciton.burchellii	S
Eciton.hamatum	S
Eciton.mexicanum	S
Eciton.rapax	S
Eciton.vagans	S
Ectatomma.brunneum	R
Ectatomma.edentatum	R
Ectatomma.ruidum	R
Ectatomma.tuberculatum	R
Eurhopalothrix.biroi	R
Eurhopalothrix.heliscata	R
Forelius.damiani	R
Forelius.pruinosus	R
Formica.aquilonia	R
Formica.archboldi	R
Formica.bruni	R
Formica.cinerea	R
Formica.clara	R
Formica.cunicularia	R
Formica.exsecta	R
Formica.exsectoides	R
Formica.fusca	R
Formica.glacialis	R
Formica.incerta	R
Formica.japonica	R
Formica.lemani	R
Formica.lugubris	R
Formica.obscuripes	R
Formica.pallidefulva	R
Formica.paralugubris	R
Formica.picea	R
Formica.podzolica	R
Formica.polyctena	R
Formica.pratensis	R
Formica.rufa	R
Formica.rufibarbis	R
Formica.sanguinea	R
Formica.subintegra	R
Formica.subsericea	R
Formica.truncorum	R
Formica.yessensis	R
Formicoxenus.provancheri	R
Gnamptogenys.bicolor	R
Gnamptogenys.menadensis	G
Gnamptogenys.striatula	G
Harpegnathos.saltator	G
Hypoponera.eduardi	S
Iridomyrmex.purpureus	R
Labidus.coecus	R
Labidus.praedator	R
Lasius.alienus	R
Lasius.brunneus	R
Lasius.carniolicus	R
Lasius.emarginatus	R
Lasius.flavus	R
Lasius.fuliginosus	R
Lasius.grandis	R
Lasius.jensi	R
Lasius.meridionalis	R
Lasius.myops	R
Lasius.neglectus	R
Lasius.neoniger	R
Lasius.niger	R
Lasius.paralienus	R
Lasius.platythorax	R
Lasius.psammophilus	R
Lasius.reginae	R
Lasius.umbratus	R
Leptanilla.japonica	R
Leptogenys.peuqueti	G
Leptogenys.schwabi	G
Leptomyrmex.erythrocephalus	R
Leptomyrmex.fragilis	R
Leptomyrmex.nigriventris	R
Leptomyrmex.unicolor	R
Leptothorax.acervorum	R
Leptothorax.muscorum	R
Linepithema.humile	R
Liometopum.apiculatum	R
Liometopum.occidentale	R
Manica.rubida	R
Megaponera.analis	R
Melophorus.bagoti	R
Meranoplus.mucronatus	R
Mesoponera.caffraria	R
Messor.aciculatus	R
Messor.aegyptiacus	R
Messor.arenarius	R
Messor.barbarus	R
Messor.bouvieri	R
Messor.capitatus	R
Messor.ebeninus	R
Messor.minor	R
Messor.structor	R
Messor.wasmanni	R
Metapone.madagascarica	G
Monomorium.floricola	S
Monomorium.minimum	S
Monomorium.pharaonis	S
Monomorium.rothsteini	S
Myopias.concava	R
Myopias.julivora	R
Myrmecia.pyriformis	G
Myrmecina.americana	R
Myrmecina.graminicola	R
Myrmecina.nipponica	R
Myrmecocystus.depilis	R
Myrmecocystus.mendax	R
Myrmecocystus.mexicanus	R
Myrmecocystus.mimicus	R
Myrmica.curvithorax	R
Myrmica.gallienii	R
Myrmica.incompleta	R
Myrmica.lobicornis	R
Myrmica.punctiventris	R
Myrmica.rubra	R
Myrmica.ruginodis	R
Myrmica.rugulosa	R
Myrmica.sabuleti	R
Myrmica.scabrinodis	R
Myrmica.schencki	R
Myrmica.specioides	R
Myrmicaria.brunnea	R
Myrmicaria.natalensis.eumenoides	R
Myrmicocrypta.ednaella	R
Myrmoteras.barbouri	R
Myrmoteras.iriodum	R
Myrmoteras.jaitrongi	R
Myrmoteras.toro	R
Neivamyrmex.nigrescens	R
Neivamyrmex.opacithorax	R
Neivamyrmex.texanus	R
Neoponera.apicalis	R
Neoponera.commutata	R
Neoponera.obscuricornis	R
Neoponera.verenae	R
Neoponera.villosa	R
Nesomyrmex.echinatinodis	R
Nesomyrmex.spininodis	R
Nomamyrmex.esenbeckii	R
Nothomyrmecia.macrops	R
Novomessor.cockerelli	R
Nylanderia.fulva	R
Ochetellus.glaber	R
Ocymyrmex.foreli	R
Odontomachus.affinis	R
Odontomachus.bauri	R
Odontomachus.brunneus	R
Odontomachus.chelifer	R
Odontomachus.clarus	R
Odontomachus.haematodus	R
Odontomachus.hastatus	R
Odontomachus.laticeps	R
Odontomachus.opaciventris	R
Odontomachus.troglodytes	R
Oecophylla.longinoda	R
Oecophylla.smaragdina	R
Onychomyrmex.hedleyi	R
Ooceraea.biroi	R
Ophthalmopone.berthoudi	G
Orectognathus.versicolor	R
Pachycondyla.harpax	R
Pachycondyla.striata	R
Paraponera.clavata	R
Paratrechina.longicornis	R
Pheidole.bicornis	S
Pheidole.dentata	S
Pheidole.fallax	S
Pheidole.megacephala	S
Pheidole.morrisii	S
Pheidole.pallidula	S
Pheidole.spadonia	S
Pheidole.specularis	S
Plagiolepis.pygmaea	R
Platythyrea.lamellosa	G
Platythyrea.modesta	G
Platythyrea.parallela	G
Platythyrea.punctata	G
Platythyrea.quadridenta	G
Platythyrea.schultzei	G
Platythyrea.tricuspidata	G
Pogonomyrmex.badius	R
Pogonomyrmex.barbatus	R
Pogonomyrmex.californicus	R
Pogonomyrmex.imberbiculus	R
Pogonomyrmex.maricopa	R
Pogonomyrmex.montanus	R
Pogonomyrmex.occidentalis	R
Pogonomyrmex.rugosus	R
Pogonomyrmex.subnitidus	R
Pogonomyrmex.texanus	R
Polyrhachis.arachne	R
Polyrhachis.dives	R
Polyrhachis.hodgsoni	R
Polyrhachis.laboriosa	R
Polyrhachis.loweryi	R
Polyrhachis.moesta	R
Ponera.coarctata	R
Ponera.exotica	R
Ponera.pennsylvanica	R
Ponera.testacea	R
Prenolepis.imparis	R
Prenolepis.nitens	R
Prionopelta.amabilis	R
Prionopelta.opaca	R
Pristomyrmex.punctatus	R
Proatta.butteli	R
Probolomyrmex.boliviensis	R
Probolomyrmex.dammermani	R
Probolomyrmex.longinodus	R
Proceratium.croceum	R
Proceratium.goliath	R
Proceratium.itoi	R
Proceratium.pergandei	R
Proceratium.silaceum	R
Proformica.epinotalis	R
Protanilla.lini	R
Pseudomyrmex.concolor	R
Pseudomyrmex.ejectus	R
Pseudomyrmex.elongatus	R
Pseudomyrmex.ferrugineus	R
Pseudomyrmex.gracilis	R
Pseudomyrmex.oculatus	R
Pseudomyrmex.pallidus	R
Pseudomyrmex.penetrator	R
Pseudomyrmex.peperi	R
Pseudomyrmex.satanicus	R
Pseudomyrmex.spinicola	R
Pseudomyrmex.tenuis	R
Pseudomyrmex.termitarius	R
Rhytidoponera.chalybaea	G
Rhytidoponera.mayri	G
Rhytidoponera.metallica	G
Solenopsis.fugax	S
Solenopsis.geminata	S
Solenopsis.invicta	S
Solenopsis.picta	S
Stenamma.brevicorne	R
Stenamma.debile	R
Stenamma.diecki	R
Stenamma.impar	R
Stigmatomma.reclinatum	G
Streblognathus.aethiopicus	G
Strumigenys.emarginata	S
Strumigenys.hexamera	S
Strumigenys.lewisi	S
Strumigenys.louisianae	S
Strumigenys.lujae	S
Strumigenys.membranifera	S
Strumigenys.rogeri	S
Strumigenys.rostrata	S
Strumigenys.serrula	S
Strumigenys.solifontis	S
Tapinoma.erraticum	R
Tapinoma.madeirense	R
Tapinoma.melanocephalum	R
Tapinoma.minutum	R
Tapinoma.nigerrimum	R
Tapinoma.sessile	R
Tapinoma.subboreale	R
Tatuidris.tatusia	R
Technomyrmex.albipes	R
Temnothorax.albipennis	R
Temnothorax.ambiguus	R
Temnothorax.andrei	R
Temnothorax.crassispinus	R
Temnothorax.curvispinosus	R
Temnothorax.interruptus	R
Temnothorax.longispinosus	R
Temnothorax.nigriceps	R
Temnothorax.nylanderi	R
Temnothorax.parvulus	R
Temnothorax.rugatulus	R
Temnothorax.tuberum	R
Temnothorax.unifasciatus	R
Tetramorium.alpestre	S
Tetramorium.bicarinatum	S
Tetramorium.caespitum	S
Tetramorium.impurum	S
Tetramorium.semilaeve	S
Tetramorium.simillimum	S
Tetramorium.tsushimae	S
Tetraponera.rufonigra	R
Thaumatomyrmex.atrox	G
Thaumatomyrmex.contumax	G
Typhlomyrmex.rogenhoferi	R
Wasmannia.auropunctata	R
Xenomyrmex.floridanus	R
